[MapFileInfo]
Product = 28
Provider = 0x10
MapVer = 0x01
SWVersion = 5
Time = 170620
Date = 000404

[0073]              ; Bearbeiter: K.H. Rathgeb
Offset =       0    ; Offset
Memory =       2    ; EELiteBlock
PStufe =      16    ; KT
Service =      2    ; Block neu initialisieren
Version =      1    ; Version
DataSize =    270   ; Anzahl der Datenbytes
Data     {
0x14 0x00 0xFF 0xFF 0xFF 0xFF 0xFF 0xFF 0xFF 0xFF 
0xFF 0xFF 0xFF 0xFF 0xFF 0xFF 0xFF 0xFF 0xFF 0xFF 
0xFF 0xFF 0xFF 0xFF 0xFF 0xFF 0xFF 0xFF 0xFF 0xFF 
0xFF 0xFF 0xFF 0xFF 0xFF 0xFF 0xFF 0xFF 0xFF 0xFF 
0xFF 0xFF 0x00 0x00 0xFF 0xFF 0xFF 0xFF 0xFF 0xFF 
0xFF 0xFF 0xFF 0xFF 0xFF 0xFF 0xFF 0xFF 0xFF 0xFF 
0xFF 0xFF 0xFF 0xFF 0xFF 0xFF 0xFF 0xFF 0xFF 0xFF 
0xFF 0xFF 0xFF 0xFF 0xFF 0xFF 0xFF 0xFF 0xFF 0xFF 
0xFF 0xFF 0xFF 0xFF 0xFF 0xFF 0xFF 0xFF 0xFF 0xFF 
0xFF 0xFF 0xFF 0xFF 0xFF 0xFF 0xFF 0xFF 0xFF 0xFF 
0xFF 0xFF 0x01 0x01 0x01 0x01 0x01 0x01 0x01 0x01 
0x01 0x01 0x01 0x01 0x01 0x01 0x01 0x01 0x01 0x01 
0x01 0x01 0x00 0x01 0x01 0x01 0x01 0x01 0x01 0x01 
0x01 0x01 0x01 0x01 0x01 0x01 0x01 0x01 0x01 0x01 
0x01 0x01 0x01 0x01 0x01 0x01 0x01 0x01 0x01 0x01 
0x01 0x01 0x00 0x01 0x02 0x03 0x04 0x05 0x06 0x07 
0x08 0x09 0x0A 0x0B 0x0C 0x0D 0x0E 0x0F 0x10 0x11 
0x12 0x13 0x14 0x15 0x16 0x17 0x18 0x19 0x1A 0x1B 
0x1C 0x1D 0x1E 0x1F 0x20 0x21 0x22 0x23 0x24 0x25 
0x26 0x27 0x28 0x29 0x2A 0x2B 0x2C 0x2D 0x2E 0x2F 
0x30 0x31 0x93 0x02 0x42 0x04 0x93 0x02 0x44 0x00 
0xFF 0xFF 0x44 0x00 0xBA 0x02 0x32 0x03 0x93 0x02 
0x88 0x00 0x4B 0x02 0x88 0x00 0x0B 0x02 0x42 0x04 
0xFF 0xFF 0x42 0x04 0x0B 0x02 0x42 0x04 0x0B 0x02 
0x44 0x00 0xFF 0xFF 0x44 0x00 0x4B 0x02 0x32 0x03 
0x0B 0x02 0x88 0x00 0xEE 0x01 0x88 0x00 0xB8 0x01 
0x42 0x04 0xFF 0xFF 0x42 0x04 0xFC 0xFF 0x01 0xFF
         }

[CheckSum]
Key = 170528    ; CheckByte: 0x20
