[MapFileInfo]
Product = 28
Provider = 0x0C
MapVer = 0x01
SWVersion = 5
Time = 170620
Date = 000404

[5076]              ; Bearbeiter: T. Kreﬂler
Offset =       0    ; Offset
Memory =       8    ; EEFullBlock
PStufe =      16    ; KT
Service =      2    ; Block neu initialisieren
Version =      1    ; Version
DataSize =     32   ; Anzahl der Datenbytes
Data     {
0x53 0x69 0x65 0x6D 0x65 0x6E 0x73 0x20 0x4D 0x33 
0x35 0x69 0xFF 0xFF 0xFF 0xFF 0xFF 0xFF 0xFF 0xFF 
0xFF 0xFF 0xFF 0xFF 0xFF 0xFF 0xFF 0xFF 0xFF 0xFF 
0xFF 0xFF
         }
[0140]              ; Bearbeiter: J. Riepen
Offset =       0    ; Offset
Memory =       2    ; EELiteBlock
PStufe =      16    ; KT
Service =      2    ; Block neu initialisieren
Version =      4    ; Version
DataSize =     70   ; Anzahl der Datenbytes
Data     {
0x02 0x00 0x0B 0x00 0xA0 0x0F 0x02 0x04 0x0A 0x3C 
0x74 0x0E 0x02 0x05 0x0B 0x3E 0x80 0x0C 0x02 0x05 
0x0C 0x43 0x54 0x0B 0x03 0x05 0x0B 0x3C 0x28 0x0A 
0x03 0x05 0x0D 0x35 0x98 0x08 0x02 0x06 0x0E 0x2F 
0x46 0x05 0x03 0x06 0x10 0x35 0x06 0x04 0x03 0x07 
0x13 0x38 0x90 0x01 0x04 0x09 0x1B 0x37 0xC8 0x00 
0x06 0x0C 0x2B 0x37 0x64 0x00 0x08 0x10 0x38 0x38
         }
[0070]              ; Bearbeiter: M. Kugler
Offset =       0    ; Offset
Memory =       2    ; EELiteBlock
PStufe =      16    ; KT
Service =      2    ; Block neu initialisieren
Version =      1    ; Version
DataSize =     10   ; Anzahl der Datenbytes
Data     {
0xA9 0x66 0xA6 0x00 0x00 0x00 0x00 0x00 0x00 0x00
         }
[0069]              ; Bearbeiter: C. Koehl
Offset =       0    ; Offset
Memory =       2    ; EELiteBlock
PStufe =      16    ; KT
Service =      2    ; Block neu initialisieren
Version =      2    ; Version
DataSize =   2048   ; Anzahl der Datenbytes
Data     {
0x01 0x00 0x16 0x00 0x14 0x00 0x06 0x00 0x9C 0x00 
0x1E 0x02 0x14 0x00 0x21 0x00 0x2E 0x00 0x3B 0x00 
0x21 0x00 0x48 0x00 0x7C 0x00 0x89 0x00 0x3B 0x00 
0x55 0x00 0x62 0x00 0x6F 0x00 0x00 0x00 0x00 0x00 
0x00 0x00 0x00 0x00 0x00 0x00 0x21 0x00 0x48 0x00 
0x3B 0x00 0x20 0x33 0x00 0x40 0x00 0x40 0x00 0x40 
0x00 0x40 0x00 0x40 0xC0 0x00 0xC0 0x00 0xC0 0x00 
0xC0 0x00 0xC0 0x00 0x00 0x00 0x00 0x00 0x20 0x33 
0x01 0x20 0xFF 0x17 0xE7 0x23 0xD9 0x35 0xFF 0x2F 
0x48 0x00 0xC0 0x00 0xC0 0x00 0xD8 0x00 0x00 0x00 
0x01 0x20 0x00 0x00 0x04 0x28 0xC0 0x15 0xC8 0x1F 
0x82 0x17 0xC5 0x22 0x90 0x33 0x08 0x00 0x08 0x00 
0x18 0x00 0x18 0x00 0x18 0x00 0x00 0x00 0x02 0x00 
0x04 0x28 0x44 0x11 0xFC 0x1C 0x55 0x18 0xD9 0x28 
0xAC 0x44 0x08 0x00 0x08 0x00 0x18 0x00 0x18 0x00 
0x18 0x00 0x00 0x00 0x02 0x00 0x04 0x3C 0xD1 0x05 
0x5A 0x0B 0xB0 0x16 0x60 0x2D 0xC0 0x5A 0x10 0x00 
0x10 0x00 0x10 0x00 0x10 0x00 0x10 0x00 0x55 0x05 
0x02 0x00 0x04 0x28 0x80 0x30 0x80 0x30 0x80 0x30 
0x80 0x30 0x80 0x30 0x18 0x00 0x18 0x00 0x18 0x00 
0x18 0x00 0x18 0x00 0x00 0x10 0x02 0x00 0x04 0x34 
0xA0 0x03 0x4C 0x05 0xD6 0x07 0x97 0x0B 0x98 0x08 
0x08 0x00 0x08 0x00 0x08 0x00 0x08 0x00 0x18 0x00 
0x00 0x00 0x02 0x00 0x04 0x34 0x44 0x11 0xFC 0x1C 
0x55 0x18 0xD9 0x28 0xAC 0x44 0x08 0x00 0x08 0x00 
0x18 0x00 0x18 0x00 0x18 0x00 0x00 0x00 0x02 0x00 
0x04 0x33 0x40 0x0C 0x80 0x14 0x60 0x22 0xC0 0x39 
0x80 0x30 0x48 0x00 0xC8 0x00 0xC8 0x00 0xC8 0x00 
0x18 0x00 0x00 0x00 0x03 0x00 0x20 0x28 0x01 0x20 
0xFF 0x17 0xE7 0x23 0xD9 0x35 0xFF 0x2F 0x48 0x00 
0xC0 0x00 0xC0 0x00 0xD8 0x00 0x00 0x00 0x01 0x20 
0x00 0x00 0x14 0x00 0x2A 0x00 0x74 0x00 0x91 0x00 
0x2A 0x00 0xDF 0x00 0x27 0x01 0x4D 0x01 0x72 0x01 
0x11 0x01 0xAE 0x00 0xAE 0x00 0x00 0x00 0x00 0x00 
0x00 0x00 0x00 0x00 0x00 0x00 0x2A 0x00 0x14 0x00 
0x14 0x00 0x05 0x00 0x02 0x00 0x05 0x00 0x08 0x00 
0x0F 0x00 0x03 0x00 0x0A 0x00 0x01 0x02 0x84 0x02 
0xBA 0xCA 0x8C 0x06 0x3E 0x9B 0xFC 0x99 0x5D 0x56 
0x07 0x55 0x8D 0x75 0x80 0x08 0x04 0x00 0x88 0x0E 
0x00 0x00 0x05 0x10 0xBA 0xCA 0x05 0x00 0x07 0x00 
0x05 0x00 0x08 0x00 0x43 0x00 0x03 0x00 0x04 0x00 
0x01 0x02 0x82 0x00 0xBA 0xCA 0xFF 0x7F 0x0B 0x00 
0x8A 0x04 0x49 0x92 0x06 0x99 0xB7 0x6D 0xEA 0x56 
0xB7 0x6D 0x49 0x92 0x70 0x8E 0xB7 0x6D 0xD5 0x67 
0xB7 0x6D 0x0B 0x00 0x8C 0x0A 0xA7 0x60 0x6E 0x5B 
0xA7 0x60 0xBB 0x4A 0xA7 0x60 0x8E 0x0C 0x80 0x00 
0x80 0x7F 0x00 0x10 0x92 0x50 0x08 0x00 0x86 0x12 
0xBA 0xCA 0x90 0x16 0x00 0x10 0x00 0x04 0x80 0x1A 
0x88 0x1C 0x00 0x00 0x06 0x00 0x8F 0x22 0x80 0x00 
0x80 0x7F 0x00 0x20 0x00 0x20 0x87 0x24 0x0B 0x00 
0x8B 0x28 0xD4 0xEA 0x70 0x0E 0xEC 0x48 0x34 0x39 
0xFF 0x7F 0x9A 0xF0 0xBD 0x06 0x93 0x35 0xFA 0x24 
0xFF 0x7F 0x0A 0x00 0x8D 0x2E 0x8D 0x75 0x1F 0x30 
0x8D 0x75 0x17 0x12 0x8D 0x75 0x84 0x32 0x00 0x20 
0x05 0x34 0xBA 0xCA 0x05 0x00 0x03 0x00 0x05 0x00 
0x08 0x00 0x16 0x00 0x03 0x00 0x04 0x00 0x01 0x02 
0x82 0x00 0xBA 0xCA 0x00 0x6C 0x0B 0x00 0x8A 0x04 
0x37 0xA8 0x0B 0x94 0xCB 0x57 0x2D 0x62 0xCB 0x57 
0x4B 0xD4 0xF8 0xD6 0x0F 0x1B 0x4C 0x2F 0xFF 0x7F 
0x05 0x00 0x80 0x0A 0x88 0x0E 0x00 0x00 0x05 0x10 
0xBA 0xCA 0x05 0x00 0x03 0x00 0x05 0x00 0x08 0x00 
0x16 0x00 0x03 0x00 0x04 0x00 0x01 0x02 0x82 0x00 
0xBA 0xCA 0x0F 0x22 0x0B 0x00 0x8A 0x04 0x37 0xA8 
0x0B 0x94 0xCB 0x57 0x2D 0x62 0xCB 0x57 0xEB 0xB4 
0x9D 0xA6 0x02 0x42 0x5F 0x59 0xFF 0x7F 0x05 0x00 
0x80 0x0A 0x88 0x0E 0x00 0x00 0x05 0x10 0xBA 0xCA 
0x05 0x00 0x05 0x00 0x05 0x00 0x08 0x00 0x2A 0x00 
0x03 0x00 0x04 0x00 0x01 0x02 0x82 0x00 0xBA 0xCA 
0xFF 0x7F 0x0B 0x00 0x8A 0x04 0x49 0x92 0x06 0x99 
0xB7 0x6D 0xEA 0x56 0xB7 0x6D 0x49 0x92 0x70 0x8E 
0xB7 0x6D 0xD5 0x67 0xB7 0x6D 0x0B 0x00 0x8B 0x08 
0xA7 0x60 0x6E 0x5B 0xA7 0x60 0xBB 0x4A 0xA7 0x60 
0xA3 0xBA 0x9D 0xA6 0x93 0x33 0x95 0x55 0xFF 0x7F 
0x0A 0x00 0x8E 0x0E 0x80 0x00 0x80 0x7F 0x00 0x10 
0xFF 0x7F 0x86 0x12 0xBA 0xCA 0x80 0x16 0x88 0x18 
0x00 0x00 0x02 0x00 0x05 0x1C 0xBA 0xCA 0x05 0x00 
0x05 0x00 0x05 0x00 0x08 0x00 0x2B 0x00 0x03 0x00 
0x04 0x00 0x01 0x02 0x82 0x00 0xBA 0xCA 0x6E 0x65 
0x0B 0x00 0x8A 0x04 0x37 0xA8 0x0B 0x94 0xCB 0x57 
0x2D 0x62 0xCB 0x57 0x00 0xC0 0x99 0xD9 0x33 0x33 
0x67 0x26 0xFF 0x7F 0x0B 0x00 0x8E 0x0A 0x80 0x00 
0x80 0x7F 0x00 0x20 0x00 0x40 0x86 0x0E 0xBA 0xCA 
0x80 0x12 0x88 0x16 0x00 0x00 0x87 0x18 0x0B 0x00 
0x8E 0x1E 0x80 0x00 0x80 0x7F 0x00 0x20 0x00 0x40 
0x8D 0x20 0xA7 0xC9 0xD0 0xD5 0x00 0x00 0x00 0x00 
0xFF 0x7F 0x02 0x00 0x05 0x24 0xBA 0xCA 0x05 0x00 
0x02 0x00 0x05 0x00 0x08 0x00 0x0F 0x00 0x03 0x00 
0x0A 0x00 0x01 0x02 0x82 0x02 0xBA 0xCA 0xCF 0x71 
0x86 0x06 0xBA 0xCA 0x80 0x0A 0x88 0x0E 0x00 0x00 
0x87 0x10 0x04 0x00 0x84 0x16 0x6B 0x19 0x05 0x18 
0xBA 0xCA 0x05 0x00 0x04 0x00 0x05 0x00 0x08 0x00 
0x1F 0x00 0x03 0x00 0x04 0x00 0x01 0x02 0x82 0x00 
0xBA 0xCA 0xFF 0x7F 0x0B 0x00 0x8A 0x04 0x49 0x92 
0x06 0x99 0xB7 0x6D 0xEA 0x56 0xB7 0x6D 0x49 0x92 
0x70 0x8E 0xB7 0x6D 0xD5 0x67 0xB7 0x6D 0x0B 0x00 
0x8C 0x0A 0xA7 0x60 0x6E 0x5B 0xA7 0x60 0xBB 0x4A 
0xA7 0x60 0x80 0x0E 0x88 0x12 0x00 0x00 0x84 0x14 
0x00 0x40 0x02 0x00 0x05 0x18 0xBA 0xCA 0x05 0x00 
0x03 0x00 0x05 0x00 0x08 0x00 0x1E 0x00 0x03 0x00 
0x07 0x00 0x01 0x02 0x82 0x02 0xBA 0xCA 0x00 0x48 
0x80 0x06 0x88 0x08 0x00 0x00 0x0B 0x00 0x8B 0x0C 
0xD4 0xEA 0x70 0x0E 0xEC 0x48 0x34 0x39 0xFF 0x7F 
0x9A 0xF0 0xBD 0x06 0x93 0x35 0xFA 0x24 0xFF 0x7F 
0x0A 0x00 0x8D 0x12 0x8D 0x75 0x1F 0x30 0x8D 0x75 
0x17 0x12 0x8D 0x75 0x84 0x16 0x00 0x20 0x05 0x18 
0xBA 0xCA 0x05 0x00 0x01 0x00 0x05 0x00 0x08 0x00 
0x09 0x00 0x03 0x00 0x09 0x00 0x01 0x02 0x82 0x02 
0xBA 0xCA 0x00 0x40 0x80 0x06 0x88 0x0A 0x00 0x00 
0x05 0x0C 0xBA 0xCA 0xEA 0x00 0x14 0x00 0x38 0x00 
0x38 0x00 0x14 0x00 0xC6 0x00 0x00 0x00 0x00 0x00 
0x00 0x00 0x00 0x00 0x7F 0x00 0x7F 0x00 0x00 0x00 
0x00 0x00 0x00 0x00 0x00 0x00 0x00 0x00 0x14 0x00 
0xEA 0x00 0xEA 0x00 0x0B 0x00 0x8C 0x00 0x20 0x00 
0x3C 0x00 0x64 0x00 0x00 0x00 0x00 0x04 0xFC 0xFF 
0xFF 0xFF 0xFF 0xFF 0x19 0x00 0x66 0x66 0x0B 0x00 
0x8D 0x01 0xF6 0x40 0x00 0x40 0xF4 0x01 0x03 0x00 
0x0A 0x00 0x04 0x00 0x06 0x00 0x00 0x10 0x02 0x00 
0x00 0x00 0x0B 0x10 0x09 0x02 0x00 0x40 0x9C 0xFF 
0xA2 0xFE 0x0C 0xFE 0xFF 0xFF 0xFD 0xFF 0xFF 0xFF 
0xC5 0x40 0x00 0x20 0x05 0x00 0x0B 0x00 0x8C 0x00 
0x20 0x00 0x3C 0x00 0x64 0x00 0x00 0x00 0x00 0x08 
0xFC 0xFF 0xFF 0xFF 0xFF 0xFF 0x19 0x00 0x66 0x66 
0x0B 0x00 0x8D 0x01 0x9A 0x41 0x00 0x40 0x00 0x04 
0x00 0x00 0x0A 0x00 0x02 0x00 0x03 0x00 0x00 0x02 
0x04 0x00 0x00 0x00 0x09 0x00 0x8F 0x02 0xFE 0xFF 
0x00 0x00 0x00 0x00 0x00 0x00 0x33 0x43 0x8F 0x02 
0x01 0x00 0xC2 0x01 0x0B 0x00 0x89 0x03 0xCD 0x3C 
0x88 0xFF 0x6A 0xFF 0x70 0xFE 0xFF 0xFF 0xFD 0xFF 
0xFF 0xFF 0xC5 0x40 0x66 0x26 0x05 0x00 0x09 0x00 
0x90 0x04 0x06 0xFF 0x9A 0x19 0x33 0x73 0xCE 0xFF 
0x06 0xFF 0x00 0x40 0x38 0xFF 0xA8 0xFD 0x02 0x00 
0x0E 0x05 0x14 0x00 0x0B 0x10 0x0B 0x10 0xBA 0xFF 
0x06 0xFF 0x3E 0xFE 0x0C 0xFE 0x78 0x00 0x9C 0xFF 
0xFD 0xFF 0xFF 0xFF 0x6A 0xFF 0x70 0xFE 0x0B 0x00 
0x8C 0x00 0x20 0x00 0x3C 0x00 0x64 0x00 0x00 0x00 
0x00 0x08 0xFC 0xFF 0xFF 0xFF 0xFF 0xFF 0x19 0x00 
0x66 0x66 0x0B 0x00 0x8D 0x01 0x9A 0x41 0x00 0x40 
0x00 0x04 0x00 0x00 0x0A 0x00 0x02 0x00 0x03 0x00 
0x00 0x00 0x04 0x00 0x00 0x00 0x09 0x00 0x8F 0x02 
0xFE 0xFF 0x00 0x00 0x00 0x00 0x00 0x00 0x33 0x43 
0x00 0x00 0x01 0x00 0xC2 0x01 0x0B 0x00 0x89 0x03 
0xCD 0x3C 0x88 0xFF 0x9C 0xFF 0xA2 0xFE 0xFF 0xFF 
0xFD 0xFF 0xFF 0xFF 0xC5 0x40 0x66 0x26 0x05 0x00 
0x09 0x00 0x90 0x04 0xD4 0xFE 0x33 0x13 0x33 0x73 
0xFF 0xFF 0x9C 0xFF 0x00 0x40 0xD4 0xFE 0xA8 0xFD 
0x02 0x00 0x0E 0x05 0x14 0x00 0x0B 0x10 0x0B 0x10 
0xBA 0xFF 0x06 0xFF 0x3E 0xFE 0x0C 0xFE 0x78 0x00 
0x9C 0xFF 0xFD 0xFF 0xFF 0xFF 0x9C 0xFF 0xA2 0xFE 
0x0B 0x00 0x8C 0x00 0x20 0x00 0x3C 0x00 0x64 0x00 
0x00 0x00 0x00 0x10 0xFB 0xFF 0xFF 0xFF 0xFF 0xFF 
0x19 0x00 0x66 0x66 0x0B 0x00 0x8D 0x01 0x9A 0x41 
0x52 0x38 0xF4 0x01 0x05 0x00 0x0F 0x00 0x02 0x00 
0x04 0x00 0x00 0x06 0x03 0x00 0x00 0x00 0x0B 0x10 
0x09 0x02 0x00 0x40 0x9C 0xFF 0x00 0x00 0xA8 0xFD 
0xFF 0xFF 0xFD 0xFF 0xFF 0xFF 0xC5 0x40 0x00 0x20 
0x05 0x00 0x0B 0x00 0x8C 0x00 0x20 0x00 0x3C 0x00 
0x64 0x00 0x00 0x00 0x00 0x04 0xFC 0xFF 0xFF 0xFF 
0xFF 0xFF 0x19 0x00 0x66 0x66 0x0B 0x00 0x8D 0x01 
0xF6 0x40 0x00 0x40 0xF4 0x01 0x03 0x00 0x0A 0x00 
0x04 0x00 0x06 0x00 0x00 0x00 0x02 0x00 0x00 0x00 
0x0B 0x00 0x89 0x02 0xCD 0x2C 0xB0 0xFF 0x00 0x00 
0x0C 0xFE 0xFF 0xFF 0xFD 0xFF 0xFF 0xFF 0xC5 0x40 
0x00 0x20 0x05 0x00 0x02 0x10 0x0E 0x03 0x04 0x00 
0x00 0x00 0x00 0x00 0x00 0x00 0x00 0x00 0x00 0x00 
0x00 0x00 0x00 0x00 0x00 0x00 0x00 0x00 0x00 0x00 
0x00 0x00 0x00 0x00 0x00 0x00 0x00 0x00 0x00 0x00 
0x00 0x00 0x00 0x00 0x00 0x00 0x00 0x00 0x00 0x00 
0x00 0x00 0x00 0x00 0x00 0x00 0x00 0x00 0x00 0x00 
0x00 0x00 0x00 0x00 0x00 0x00 0x00 0x00 0x00 0x00 
0x00 0x00 0x00 0x00 0x00 0x00 0x00 0x00 0x00 0x00 
0x00 0x00 0x00 0x00 0x00 0x00 0x00 0x00 0x00 0x00 
0x00 0x00 0x00 0x00 0x00 0x00 0x00 0x00 0x00 0x00 
0x00 0x00 0x00 0x00 0x00 0x00 0x00 0x00 0x00 0x00 
0x00 0x00 0x00 0x00 0x00 0x00 0x00 0x00 0x00 0x00 
0x00 0x00 0x00 0x00 0x00 0x00 0x00 0x00 0x00 0x00 
0x00 0x00 0x00 0x00 0x00 0x00 0x00 0x00 0x00 0x00 
0x00 0x00 0x00 0x00 0x00 0x00 0x00 0x00 0x00 0x00 
0x00 0x00 0x00 0x00 0x00 0x00 0x00 0x00 0x00 0x00 
0x00 0x00 0x00 0x00 0x00 0x00 0x00 0x00 0x00 0x00 
0x00 0x00 0x00 0x00 0x00 0x00 0x00 0x00 0x00 0x00 
0x00 0x00 0x00 0x00 0x00 0x00 0x00 0x00 0x00 0x00 
0x00 0x00 0x00 0x00 0x00 0x00 0x00 0x00 0x00 0x00 
0x00 0x00 0x00 0x00 0x00 0x00 0x00 0x00 0x00 0x00 
0x00 0x00 0x00 0x00 0x00 0x00 0x00 0x00 0x00 0x00 
0x00 0x00 0x00 0x00 0x00 0x00 0x00 0x00 0x00 0x00 
0x00 0x00 0x00 0x00 0x00 0x00 0x00 0x00 0x00 0x00 
0x00 0x00 0x00 0x00 0x00 0x00 0x00 0x00 0x00 0x00 
0x00 0x00 0x00 0x00 0x00 0x00 0x00 0x00 0x00 0x00 
0x00 0x00 0x00 0x00 0x00 0x00 0x00 0x00 0x00 0x00 
0x00 0x00 0x00 0x00 0x00 0x00 0x00 0x00 0x00 0x00 
0x00 0x00 0x00 0x00 0x00 0x00 0x00 0x00 0x00 0x00 
0x00 0x00 0x00 0x00 0x00 0x00 0x00 0x00 0x00 0x00 
0x00 0x00 0x00 0x00 0x00 0x00 0x00 0x00 0x00 0x00 
0x00 0x00 0x00 0x00 0x00 0x00 0x00 0x00 0x00 0x00 
0x00 0x00 0x00 0x00 0x00 0x00 0x00 0x00 0x00 0x00 
0x00 0x00 0x00 0x00 0x00 0x00 0x00 0x00 0x00 0x00 
0x00 0x00 0x00 0x00 0x00 0x00 0x00 0x00 0x00 0x00 
0x00 0x00 0x00 0x00 0x00 0x00 0x00 0x00 0x00 0x00 
0x00 0x00 0x00 0x00 0x00 0x00 0x00 0x00 0x00 0x00 
0x00 0x00 0x00 0x00 0x00 0x00 0x00 0x00 0x00 0x00 
0x00 0x00 0x00 0x00 0x00 0x00 0x00 0x00 0x00 0x00 
0x00 0x00 0x00 0x00 0x00 0x00 0x00 0x00 0x00 0x00 
0x00 0x00 0x00 0x00 0x00 0x00 0x00 0x00 0x00 0x00 
0x00 0x00 0x00 0x00 0x00 0x00 0x00 0x00 0x00 0x00 
0x00 0x00 0x00 0x00 0x00 0x00 0x00 0x00
         }

[CheckSum]
Key = 164005    ; CheckByte: 0xA5
